111111111111111111111111111111111
1CC1CCCCCCCCC11CCCCCCCC1CCCCCCCC1
1CCCC11111CCCCC11111CCC1C11111CC1
11CC110CCCCCCC110C1CC1CCC10CCCCC1
11CC110CCCCCCC110CC1C1CCC10CCCCC1
11CC110CCCCCCC110C1C1CCCC10CCCCC1
11CC110CCCCCCC1CC1C1CCCCC10CCCCC1
11CC110CCCCCCCCCCC1CCCCCC10CCCCC1
1PCC110CCCCCCC110CCCCCCCC1ECCCCC1
111111111111111111111111111111111
