11111111111111111111111111111111111111111
1E001001000100100100100110010010010010011
11101101110110110110110111011011011011011
10000000000000000100100110010010010010011
11101101110110110110110111011011011011011
10001001000100100100100110010010010010011
11101101110110110110110111011011011011011
11101101110110110110110111011011011011011
10001001000100100100100110010010010010011
11101101110110110110110111011011011011011
10001001000100100100100110010010010010011
11101101110110110110110111011011011011011
1000100100010010010010011001C010010010011
11101101110110110110110111011011011011011
1P001001000100100000000000000010010010011
11111111111111111111111111111111111111111
