111111111111111111
100000000000000001
111000000000000101
100000000000000101
100000000000000101
100000000000000101
10N000000000000101
100000000000000101
100000000000000101
100000000000000101
100000000000000101
1C0111111111111CC1
1EC111111111111C11
1PC000000000000CC1
111111111111111111
