1111111
1010001
1100101
1000101
1010101
1010101
101E101
1010101
10101C1
10101C1
10101C1
1C11PC1
10C1C11
10C1CC1
1111111
