1111111111111111111111111
1E00000000000000000000001
1110101010010100101010101
1000000000000000000000001
1000000000000000000000001
100000000000C000000000001
100000000C000000000000001
100000000000C000000000001
100000000C000000000000001
100000000000C000000000001
10C000C000000000000000001
1P00C000C0000000000000001
1111111111111111111111111
