1111111
1000001
1110101
1000101
1000101
1000101
10N0101
1000101
1000101
1000101
1000101
1C01CC1
1EC1C11
1PC1CC1
1111111
