111111111111111111
100000000000000001
111011111111111101
1E0000000000000101
110000000100000101
100000000100000101
100000000100000101
100000000100011101
100000000100010001
1000000001000101C1
10000000010001C101
1C1111111110111CC1
10C111111110111C11
1PC000000000000CC1
111111111111111111
