111111111111111111
1E0010010010010011
111011011011011011
1000C0000010010011
111011011011011011
100010010010010011
111011011011011011
111011011011011011
100010010010010011
111011011011011011
100010010010010011
111011011011011011
100010010010010011
111011011011011011
1P0010010010010011
111111111111111111
